

                                                                   #      #
                                                                   #      #
                                                                   #      #
                                                                   #      #
                                                                   #      #
                                                                   #      #
                                                                   #      #
                                                                   #      #
                                                                   #      #
          N                                                        #      ####################################
        W + E                                                      #      #       #  #      #      #  |      #                       
          S                                                        #      #       #  |      #      |  #      #                     
                                                                   #      ###==####  ###############  ########                     
                                                                   #      #       #  #      #      #  |      #                    
                                                                   #      #       #  |      #      |  #      #                     
                                                                   #      |       #  ###############  ########                     
                                                                   #      #       #  #      #      #  |      #                     
                                                                   #      #       #  |      #      |  #      #                       
                                                                   #      #########==###############==########                             
                                                                   #      #            Hotel                 #                             
                                                                   #      ##==#####==#####==#####==#####==####                                                                 
                                                                   #      #      #      #      #      #      #                      
                                                                   #      #      #      #      #      #      #                                        
                                                                   #      ####################################                                        
                                                                   #      #                                                                                     
                                                                   #      #                                                                                     
                                                                   #      #                                                                                     
                                                                   #      #                                                                                     
                                                                   #      #                                                                                     
                                                                   #      #                         ################                                            
                                                                   #      #                         #              #                                            
                                                            #########====#########                  #   City Hall  #                                            
                                                            #                    #                  #              #                                            
                                                            #                    #                  #              #                                            
                                                            #                    #                  #              #                                            
#############################################################                    ##########################==#####################
|                                                           |     City Center    |                                               |
|                 West Main Street                          |                    |           East Main Street                    |
#############################################################                    #############==#########==#####==################
                                           #                #                    #      #               #  #         #                          
                                           #                #                    |  A   #      B        #  #    C    #                          
                                           #                #                    #      #               #  #         #                          
                                           #                #########====##########################==####  ###########            
                                           #                       #      #             |    #                                                                      
                                           #                       #      #             # E  #                                                                      
                                           #                       #      #             #    #                                                                      
                                           #      Park             #      #      D      ######                                                                      
                                           #                       #      |             #                                                                           
                                           #                       #      #             #                                                                           
                                           #                       #      ###############                                                                           
                                           #                       #      #                                                                                         
                                           #########################      #                                                                                         
                                                                   #      #                                                                                         
                                                                   #      #                                                                                         
                                                                   #      #                                                                                         
                                                                   #      #                                                                                         
                                                                   #      #                                                                                         
                                                                   #      #                                                                                         
                                                                   #      #                                                                                         
                                                                   #      #                                                                                         
                                                                   #      #                                                                                         
                                                                   #      #                                                                                         
                                                                   #      #                                                                                         
                                                                   #      #                                                                                         
                                                                   #      #                                                                                         
                                                                   #      #                                                                                         
                                                                   #      #                                                                                         
                                                                   #      #                                                                                         
                                                                   #      #                                                                                         
                                                                   #      #                                                                                         
                                                                   #      #                                                                                         
                                                                   #      #                                                                                         
                                                                   #      #                                                                                         
                                                                   #      #                                                                                         
                                                                   #      #                                                                                         